63 45
*********************** *********************
*     *   *             *         *         *
*** * * * * ***** * ***** ***** * *** ***** *
*   * * *       * * *   * *   * *   * *     *
* ***** ********* * * * * * *** *** *** *** *
*     *   *       * * *     *   *   *   * * *
* *** *** * * ***** * ******* *** *** *** * *
*   * *   * * *   * * *   *   * *     * *   *
* *** * *** *** * * * * * * *** ******* * ***
* *   * *   *   * * *   * *   *     *     * *
* * *** * *** *** ******* *** * *** * ***** *
* *     *       *         *   *   * * *     *
*************** ******* *** *** * *** * *****
*   *       *   * *   *   * *   *   * *     *
* * * ***** * *** * * ***** * ***** * ***** *
* * * *   * *     * *       * *   *   *     *
* * * * *** * ***** *** ***** *** ***** *** *
* *   *     * *   *   * *   *   *   *     * *
* ***** ******* * *** * * * *** * * ***** * *
* *           * *     * * * * *   *       * *
* *** ******* * * ******* * * ************* *
*   * *     *   * *   *   * *             * *
*** * * *** ***** * * * *** * ***** * ***** *
*   * *   *   *   * *   *   *   *   * *   * *
* ******* *** ***** ***** ***** * ***** * * *
* *       * * *   * *   *   *   *     * *   *
* * ******* * * * * *** *** *** ***** * *****
*   *   *   *   *         *   * *     * *   *
* *** * * * *********** ***** * * *** * * ***
*     *   *     *     * *   * * *   * * *   *
************* *** *** *** * * ***** * * * * *
*   *         *   * *     *   *     * * * * *
*** *********** *** *********** * ***** * * *
* * *           *             * * *     * * *
* * * *********** *********** * *** ***** * *
*   * *     *   *     *     * *   *   *   * *
* *** *** * *** * *** * ***** *** *** *** * *
* *   *   *     *   * *         *   *   * * *
* *** * *********** * ********* *** *** *** *
*     *             *   *   * *       *   * *
******* ************* * * * * ******* *** * *
*     * *     *     * *   * *       *   * * *
***** * *** *** *** ******* * ***** *** * * *
*     *   *   *   *     *   * *   *     *   *
* ******* * * *** ***** * *** * * *** ***** *
*       * * *   * *       *   * *   *   *   *
* ***** * * *** * * ********* * *** *** * ***
*     * * *   * * * *       * *   *   * * * *
*** *** * * *** * *** ***** ***** *** *** * *
* * *   * * *   *   * *   * *     * *     * *
* * * * * *** * *** * * * * * ***** ******* *
*   * * *     * *   * * *   * *     *       *
***** * ******* * * * * ***** * *** ***** ***
*     *   *     * * * *     *   * *     *   *
* ******* * ***** *** ***** ***** ***** *** *
* *       *     *     *   *     *       *   *
* *** ********* ******* * * *** * ******* * *
*   *   *   *   *   *   * * *   * *       * *
*** * *** * * *** * * *** *** * * *** ***** *
*   * *   * * *   * *   *     * *   *   * * *
* ***** *** * ***** *** *********** *** * * *
*         *           *                 *   *
*********************** *********************
