63 45
*********************** *********************
*       *     *   *         * *       *     *
* ***** * *** * * * ***** * * * ***** * *** *
* *   *     * * *   * *   *   *   * *     * *
* * * ******* * ***** * ********* * ***** * *
* * *         *   *   *       *     *   * * *
* * ******* ***** * * ******* * ***** * *** *
* * *       *   *   *     * *   *   * *     *
*** ********* * ********* * ***** * * ***** *
*   *     *   * *     *   *     * * *   * * *
* *** *** * *** * * * * *** *** * * *** * * *
* *   * * *   *   * * * *   *   * *     * * *
* * *** * *** ***** *** * ***** * ******* * *
*   *   *       *   *     *   * *     *     *
* ***** ********* *** ***** * ******* * *****
* *   *   *     *   * * *   *       * *     *
* * * *** * *** *** * * * ********* * *******
*   *     * * *     * * * *   *   * *       *
***** ***** * ***** * * * * *** * * ******* *
* *   *     *       *   * *     * * *       *
* * *** ***** ********* * ******* * * ***** *
*     *   *   *       * *     *   * *     * *
* ******* * *** *** * * ***** * * * ***** * *
* *       *   *   * * * * *   * * *   *   * *
* * ********* ***** *** * * *** ***** * *** *
* *   *   *   *     *   * * *         * *   *
* *** * * * *** ***** *** * * ********* * ***
* *   * * *     *     *   * * *   *     * * *
*** *** * ***** * ***** * * * * * *** * * * *
*   *   *   *   *     * * * *   *   * * *   *
* *** * ***** ******* *** * ******* *** *****
*   * * *           *   * *   *       * *   *
* * * * * ********* *** * *** ******* * * ***
* * * *     *     *   * *   * *     *   *   *
*** ********* *** * *** * *** * *** ******* *
*   *           * * *     *   * * * *     * *
* * * *********** *** ***** * * * * * *** * *
* * * *     *   * *     *   * * * *   *   * *
* * * ***** * * * * ***** * *** * ***** *** *
* * * *   * * *   * *     * *   *     * *   *
* *** * * * * ***** * *** *** *** *** * * ***
*   *   * * * *   * * *   *   *   *   *   * *
* * ***** * * * * * * ***** *** *** ******* *
* * *   *   *   *   *     * *   *   *     * *
* * * * *** ******* ***** * *** * *** * * * *
* *   *   * * *   *     * *     * *   * *   *
* ******* * * * * ******* ******* ***** *** *
* *     * * * * *       *       *   *   *   *
* * *** * * * * ******* ***** ***** * *** ***
* *   *   * * *     *   *     *     * * * * *
* *** *** * * ***** *** * ***** ***** * * * *
*   * *   * *     *   *   *     *     * *   *
***** * *** * * ***** *** * ***** *** * *** *
*     *   * * *     *   * * *       * *   * *
* ******* * ***** ***** * * ********* * * * *
*     * * *     *     * * *   *   *   * * * *
* *** * * ***** * * * * ***** * * * *** *** *
*   * *       * * * * *       * *   *   *   *
*** * * ******* *** *********** ***** * * ***
*   * * *     *   *           * *     * *   *
* *** *** *** *** ***** ***** * * ***** *** *
*   *       *           *       *     *     *
*********************** *********************
