63 45
*********************** *********************
*     *           *       *     *   *       *
* *** * ******* * * *** * * *** * * * ***** *
* * *         * * *   * * * * *   *   *   * *
* * ********* * ***** * * * * ********* * * *
*   *   *   * * *   * * * *     *       * * *
*** * * * * *** * * * * * ***** * * ******* *
*   * * * *   *   * * * * *   * * * *       *
* ***** * *** ***** * * *** * * *** * ***** *
*   *   * * *   *   * *     * *     *   *   *
*** * * * * *** * * * ******* ***** *** * ***
* *   * * *     * * * *     *   *   *   * * *
* ***** * * ***** * * *** ***** * *** *** * *
*       * * *   * * * *   *     *   * *     *
* ******* * * * * * * * *** ******* * ***** *
*     *   * * *   * *   *   *       *     * *
* ***** *** * ***** *** * *** *********** ***
* *     *     *   * * * * *   *     *   *   *
* * *********** *** * * * * ***** * *** *** *
* *   *     *   *   * * * *     * *     *   *
* *** * *** *** * *** * * ***** * *** *** * *
*   * *   *   *       * * *       *   *   * *
*** * *** *** ********* * * *********** *** *
*   *   *   *     *     *     *   *     * * *
* *** ***** ***** * *********** * * ***** * *
*   *     *   *   * *     *     *   * *     *
*** *** ***** * *** *** * * ********* * *****
* *   *     * * *   *   * * *         *     *
* *** *** *** * * *** ***** ******* ******* *
*   *   *     * *     *   *       *         *
* ***** ******* ***** * * ******* * *********
* *     *     *       * *         *       * *
* * ***** *** ********* ******************* *
*   *       *   *       *             *     *
* *** ********* * ******* *********** * *****
*   * *         *       *   *       *   *   *
*** * * ******* ******* *** *** *** ******* *
* * * *   *           *   *     *   *     * *
* * * *** * ************* ******* ***** * * *
*   *   * *   *       *         *       *   *
* ***** * ***** ***** * ***** ************* *
* *     *     *   *     *   * *           * *
* * ********* *** ******* *** * ********* * *
* * *     *     *     *       *   *   *   * *
* * * *** * *** ***** ***** ***** * *** *** *
* * * *     * * *   *     * *     *   *   * *
* *** ******* * *** ***** *** ******* *** * *
*   *   *       *     *   *   *         * * *
*** *** * ******* ***** *** *** ********* * *
*   *   *   *   * *   *     * *     *   * * *
* *** ***** * * * * * ******* * *** * * * * *
* *     * *   * * * *         * *   * *   * *
* ***** * ***** * * * ********* * *** * *** *
* *   * *   *   *   *       *   *   * * *   *
* * * * *** * *** ********* * ***** * * * ***
*   * *   * * * *     *   *     *   * * *   *
***** * * * * * ***** * * ******* * * ***** *
*   * * * *   *       * * *   *   * *   *   *
* *** *** * ******* *** * * * * *** *** * ***
* *   *   *   *   *   * * * * * * * * * * * *
* * *** ***** * * ***** * * * * * * * * * * *
*       *       *       *   *   *     *     *
*********************** *********************
