63 45
*********************** *********************
*     *               *                 *   *
* ***** ************* * *************** * * *
*     *     *     *   *   *           *   * *
***** ***** * ***** ***** ***** ***** ***** *
*     *   * *     *     *     * *   *     * *
* *** * * * ***** *** ******* * * * ***** * *
* *     * *       * *       * *   *   *   * *
* ******* ******* * ******* * ********* * * *
* *     *   *   * *     *   * *         * * *
* * *** *** * * * ***** * * * * ***** ***** *
*   *   *     * *   *   * * * *     * *     *
* *** *** ********* * *** *** * *** * * *****
*   * *   *         *   * *   *   * * *     *
*** * *** * *********** * * ******* * ***** *
*   *   * * *   *       * *     *   * *   * *
* ***** * * * * ***** * * ***** * *** * * * *
*   * * * * * *       * *     * * *   * *   *
*** * * *** * ********* *** *** * * *** *** *
*     * *   *         *   *     * *   * *   *
* ***** * *** ******* * ********* *** * * ***
* * *   * *   *   *   * *           * * *   *
* * * *** *** * * * ***** ********* * * *** *
* * *   *   * * * * *     *       * * *   * *
* * *** *** * * * * * ***** *** * * ***** * *
*     *     * * *   *   *   *   * *   *   * *
*** ******* *** ******* ***** *** *** * *** *
*   *     *   *       *     * *     * * * * *
* *** *** *** ***** * ***** * * ***** * * * *
*   *   * * *   *   * *   * * * *   * * * * *
*** *** * * *** * ***** * * * * * * * * * * *
* * *   * *   * *       *   * * * *   * *   *
* *** *** *** * ********* *** *** *** * *****
*     *   *   *     *   *   * *   *   * *   *
******* *** ******* * * *** * * *** *** * * *
* *   * *         *   *   *   * *   *   * * *
* * * * * ***** *** ***** ***** * *** *** * *
*   *   * *   *     *   *       * * * *   * *
* ********* * * ***** * ********* * * * *** *
*         * * * *   * *     * *   * * * *   *
********* * * *** * * ***** * * *** * * * * *
*       * * *     *   *     * *     *   * * *
* ******* * *********** ***** ***** ***** * *
*         *     *   *   *     * *     *   * *
* *********** * * * * *** * * * * ***** *** *
* *         * * * * *   * * *   *   *   *   *
* ******* * * * *** *** *** ******* * *** ***
* *       * * *   *       *     *   * *   * *
* * ******* ***** ******* * *** * *** * *** *
*   *   * * *   *     * * * *   * * * *     *
***** * * * * * *** * * * *** *** * * * *****
*     *   *   *   * * * *   * *   * * * *   *
* * ************* *** * *** * * *** * *** * *
* * *           *     *     *       *     * *
* *** ******* * ******* ************* ***** *
*   *       * * *     *   *         *     * *
*** ******* * *** * * *** *** ***** ***** * *
*   *       * *   * *   *   * * *   *   * * *
* *** ******* * *** *** *** * * * *** * *** *
* *   *     *   * * *     * * * * *   *     *
* * *** *** ***** * ******* * * * * ******* *
*       *         *           *     *       *
*********************** *********************
