63 45
*********************** *********************
*   *         *       * *         *       * *
* * * *** *** * ***** * * ***** *** * *** * *
* *   *   * * *   *     *     *     *   *   *
* ***** *** * *** *********** ********* *** *
* * *   *   *   * *       *   *       * * * *
* * * ***** *** * * ***** * *** * ***** * * *
* * *     *     *   *   * *     * *   * *   *
* * ***** * ***** *** * * ******* * * * * ***
*   * *   *     *   * * *       * * * * * * *
*** * * ******* *** *** ***** *** * * * * * *
*   * * *     *   *         *     * *   * * *
* *** * * ******* * ************* * ***** * *
*     * *       * * *           * * *       *
***** * *** *** * *** ********* *** ******* *
* *   *   *   * * *   *       *     *     * *
* * ***** *** * * * ********* * ***** *** * *
*   *   * * * * * *         *   *       * * *
* *** * * * * * * ********* ***** ******* * *
* *   *   *   * *   *   *   *     *       * *
*** ***** ***** *** * * * *** ***** ******* *
*   *   * *   *   *   * * *   *   *   *     *
* *** * *** * *** ***** * * *** * *** *******
*     * *   *   *       *       *   *       *
* ***** * ***** * ************************* *
* *   *       * *     *     *             * *
* * * ********* ***** *** * * ***** ***** * *
* * * *   *   * * *       *   *   * *   *   *
* * * * * * * * * * *********** *** * * *** *
* * *   *   *   * * *     *     *   * * *   *
*** ******* ***** * * *** *** *** *** * *****
* *       * *   *   *   *   *     *   *     *
* * ***** *** * * ***** *** * ***** ******* *
* *     *     * *     * * * *     * *   *   *
* ***** ******* ***** * * * ******* *** * ***
*   * * *   *   *   * *   *             *   *
*** * * * * * * * * ***** ******* ******* * *
*   *     * * * * * *       *   * *     * * *
* ********* * *** * * ******* * * * *** *** *
*     *   * * *   *       *   * * * * *     *
***** * *** * * *********** *** *** * ***** *
*     * *   *   *   * *     * * *   *     * *
* ***** * ******* * * * ***** * * ******* * *
* * *     *       *   *     * *   *       * *
* * * ***** * ************* * ***** * ***** *
* * * * *   * *             *   *   * *     *
* * * * * * * * ************* * *** * * *****
* *   *   * * *   *     *     *     * * *   *
* * ******* * *** * *** *** * ********* * * *
* *     *   *   *     *   * *         * * * *
* ***** * ***** ********* * ********* * * ***
* *   * *   * * *   *     * *       *   *   *
* * * * *** * * * * * ***** *** *** ******* *
*   * *   * *   * *   *   *     * *   *     *
***** *** * ***** ***** * ******* *** * *** *
*   *   *   *     *     *       *   *   *   *
* ***** ***** ***** * *** ******* * ***** ***
*   *   *     *   * *   * *   *   *   *   * *
* * * *** ***** * * *** *** * * *** *** *** *
* * * *   *     * * *   *   * * * *     *   *
* * * * *** * ***** * *** *** * * ********* *
* *     *   *       *       *               *
*********************** *********************
