63 45
*********************** *********************
*             *     *   *           *       *
***** ******* * *** * * * ***** ***** *** * *
*     * *     *   * * *   *   *       *   * *
* ***** * ******* * *** ***** ********* *** *
*     *   *       *   *       * *     * *   *
* *** * *** ********* ******* * * *** * *** *
* *   *   *   * *           *   * * * *   * *
* * ***** * * * * ********* ***** * * *** * *
* *   * * * * *   *     * * *     * * *   * *
***** * * *** ***** *** * * * ***** * * *****
*     *     * *   *   * *   *     * * *     *
* ********* * * * *** * *** *** * * * ***** *
*       * * * * *   * *   *   * * * * *     *
* ***** * * * * *** * *** *** *** * * * *** *
* *     *   *     *   *   * *   * *   *   * *
* * ***** ***** ***** * *** *** * * ***** * *
* * *   *     * *   * * *     *   *       * *
* * * * ***** *** * *** *** * ************* *
* * * * *   *   * *   *   * *     *         *
* * *** * * *** * *** *** ***** * * *********
* * *   * *   *   * * *   *     * * *       *
*** * *** * ******* * * *** ******* * ***** *
*   * *   *     *   *   * *           *   * *
* *** * ******* * * ***** * *********** * ***
* *     *   *   * *       * *           *   *
* * ******* * *** *** ***** * ************* *
* *   *     *       *       *   *   *     * *
* *** * *** ************* ***** * * * *** * *
* *     *   * *   *     *   *   * *   *   * *
* ******* *** * * * *** ***** *** ***** *** *
*   *   *   *   * * * *       *       *   * *
*** * ***** ***** * * *************** *** ***
*   *       *     *   *             *   *   *
* *** ******* ******* * ***** ***** ******* *
* * * *     *   *     * *     *   *       * *
* * * *** * *** * ******* ******* ******* * *
* * *     *   * *   *   *     *   *     *   *
* * *** ***** * *** * * *** * * *** * ***** *
* *     *   *     * * *   * * *   * *       *
* ******* * ***** * * *** * * *** * *********
*     *   * * *   *   * * * *   *   *       *
* *** * *** * * ******* * *** * *** * *** * *
* * * * *   *   *       *   * *   * * *   * *
* * * * * *** *** ***** *** ***** * * * *** *
*   *   *   *   *     *   *     * * * * *   *
*********** *** * ***** ******* * * *** * ***
*     *     * * * *     *     *   *     *   *
* *** * ***** * * * ***** *** ************* *
*   *   *   *   * * *   *   *         *     *
*** ***** *** ***** * * *** ******* * * *****
*   *   *         * * *   *   *   * * *   * *
* * * * ********* * * * * * *** * * * *** * *
* * * *         *   * * * * *   *   *   * * *
* *** ********* ***** * *** * *********** * *
* *   * *     *     * *     * *         * * *
* * *** * *** ***** * ******* * ******* * * *
* *   * * *         *       *   *     * * * *
* *** * * ********* ******* ***** ***** * * *
*   * * *         * *     *     * *     *   *
* *** * ********* *** * ******* * * ******* *
*               *     *           *         *
*********************** *********************
