63 45
*********************** *********************
*       *         *     *                   *
* * *** ******* * * *** ***** ***** ******* *
* *   *   *     * *   *     * *     * *     *
***** *** * ***** *** ***** * * ***** * *****
*   *   *   *   *   *   *   * *   *     *   *
* * *** ***** * *** *** * ******* * ******* *
* *     *     *         *         *         *
* ********* ******************************* *
*         * *     *             *   *       *
* ******* *** *** * ********* *** * * *******
* *   * * *     * * *     *   *   * * *     *
* * * * * * ***** *** *** * *** *** * *** * *
*   *   *   *     *   *   *       * *   * * *
********* *** ***** *** *** ******* *** * * *
*   *   *   *     *   *   *     *     * * * *
* * * * *** ***** *** *** *** *** ***** * * *
* *   *   *     *       * *   *   *     * * *
* ******* ************* * * *** *** ***** ***
* *               *   * * * * * *   *       *
* * ************* * * *** * * * * ********* *
* *     *   *   *   *     *   * *   *     * *
* ******* * * * ************* * *** * *** * *
* *       * * *             * *   * *   *   *
* * ******* * ********* * *** * *** * * *** *
*     *   * * *       * *   * *     * * * * *
******* * * *** ***** ***** * ******* * * * *
*     * *   *   *     *   * *   *   * * *   *
* *** * ***** ***** *** * * *** * * *** *****
* * * *   *       *     *   * * * *     *   *
* * * *** * ***** ********* * * * ******* * *
* * *     * *   *   *     *   * *         * *
*** ******* * * *** * *** ***** * ********* *
*       * *   *   * * * *     * *       *   *
* * *** * ***** *** * * ***** * ******* * ***
* * *     *     *   *   *   * * *     * *   *
*** ******* ***** ***** *** * * * *** ***** *
*   *   *   *   *     *   * *   *   * *     *
* *** * * ***** ***** *** * ******* * * *** *
*     *   *   *     *   * *         * * * * *
* ********* * * *** *** * * ********* * * * *
* *         * * *   * * * * *   *     * *   *
* ***** *** * *** * * * * * * * * ***** *****
*     *   * *     *   *   *   * * *   *     *
***** *** * ********* ********* * * * * *** *
*     * * * * *     *         * * * *   *   *
* ***** * * * * *** ********* * * * ***** * *
* *       * *   * *     *     * * *     * * *
* ********* * *** ***** * ***** * ******* ***
*           * *       * *   *   * *     *   *
************* * ***** * *** *** * * *** *** *
*     *     * * *     *   *   * *   * *     *
* *** * *** * * * ******* *** * ***** ***** *
*   * *   * * * * *     *   * * * *         *
* * * ***** * * * ***** *** * * * * *********
* * * *     * * *     *   *   * *   *       *
* * * * *** * * ***** * * ***** * ***** *** *
* * *   *   *   *     * *     * *   *   *   *
* * ************* ***** ***** * *** * *** ***
* *     *       * *   *   * *   * * * *   * *
* ***** * * ***** * * *** * ***** * * * *** *
*     *   *         *     *           *     *
*********************** *********************
