63 45
*********************** *********************
* *       *       *         *         *     *
* * *** * * *** * * ******* ******* * * *** *
* *   * * * * * *   *     * *     * * * *   *
* *** * *** * * ******* *** * *** * * * * ***
* *   * *   * *       *   * *   *   * * *   *
* * *** * *** ******* * * * *** ***** * *** *
*   * * *         *   * *   *   * *   * *   *
* *** * ********* * *** ***** *** * *** *** *
*     *         * * *   *     *     * *   * *
*** ******* ***** * * *** ***** ***** * * * *
*   *       *     * * *   *   *   *     * * *
* *** ******* ***** * *** * ***** ******* ***
*   *             * *     *     *       *   *
* ***** *********** ******* * ********* *** *
* *   * *         * *   *   *   *     * *   *
*** * *** ******* * * *** ***** * *** * * * *
*   *     *     *   *   * *   *   * *   * * *
* ******* * *** ***** * * *** ***** ***** ***
*       * *   *   * * *   *   *       *     *
* ***** *** ***** * * ***** * * ***** ***** *
*     * *   *     *   *     * *   *   *     *
***** * * *** ******* *** *** *** * *** *** *
*     * *   *   *   *     * * *   *   * * * *
* ***** *** *** * * ******* * * ***** * * * *
*   *     *   *   *       * *   *   *   *   *
*** * *** *** *********** * ***** ******* ***
* * *   *   * *   *       *     *       * * *
* * *** ***** * *** ******* *** * ***** * * *
*     * *     * *   *       * *   *   *     *
******* * ***** * *** ******* ******* *******
*     * * *     *   * *         *     *   * *
* *** * * * *** *** * ***** * * * * *** * * *
*   *   *   *   * * *     * * *   * *   * * *
* * *** ***** *** * ***** *** ******* *** * *
* *   * *     *   * *     *   *       *   * *
* *** * * ******* * ***** * *** ******* * * *
*   * * *   *     *     *   *   *   *   * * *
* *** * *** * * * ***** ***** *** * * ***** *
* *   * * * * * *   * *     * *   * *     * *
* * *** * * * * *** * ***** * * *** ***** * *
* *   * * * * *   *       *   * * * * *   * *
* *** * * * * *** ******* ***** * * * * *** *
*   * * * * *   * *     *   *   *     * *   *
***** * * * ***** * *** *** * ********* * ***
*     *   *     * * * *   * *         *   * *
* ************* * * * *** * ********* ***** *
*           *   * * *   *   *   *     *     *
* ******* *** *** * *** ***** * * *** * *****
* * *   *     *   *           *   * *   *   *
* * * * ******* ******************* * *** * *
* * * *       *         *   *   *     *   * *
* * * ***** *** ******* * * * * * ***** *** *
* *       *   * * *   *   * * * * *     *   *
* ********* * * * * * *** * * * * * ***** ***
* *       * * *   * *   * *   * * * *   *   *
* * ***** * * * *** *** * ***** *** * * *** *
*   * *   * *   *   * * *     *       * *   *
***** * ******* * *** * ***************** * *
*     * *     * *   * * *       *       * * *
* *** * * *** ***** * * * ***** * ***** * * *
*   *     *         *     *       *       * *
*********************** *********************
