63 45
*********************** *********************
*     * *     * *       *       *     *     *
* * * * * * * * * ***** * ***** * *** * *** *
* * *   * * * *     *   *   * *   *   * * * *
*** * *** * * ******* ***** * ***** *** * * *
*   * *   * *   *   *           *   *   * * *
* ***** *** *** * * * ********* * *** *** * *
*         * *   * * *   *   *   * *   *   * *
* ********* *** * * ***** * *** * * *** *** *
*   *     *   *   *       *   * * *     *   *
***** *** *** *************** * * * ***** ***
*   *   *     *             * * *   *   *   *
* * *** ******* * ********* * * ***** * *** *
* *     * *     *     *   * * * *     *   * *
* ******* * ********* * * * * * * ******* * *
*   *     * *       * * * * * * *   *   *   *
* * *** * * ***** * * * * *** * *** * ***** *
* * *   * *     * * *   *     *   * *       *
*** * ********* * ***************** *********
*   *       *   *       *         * *   *   *
* ******* * * ***** ***** ***** * * * * * * *
* *     * * *     *         *   *   * *   * *
* * *** * * ***** *** ******* * ***** ***** *
* *   * * *     *   * * *   * * *   * *   * *
* *** * * * * ***** * * * * * *** * * * * * *
*     * * * * *   * *   * *   *   * * * * * *
* ***** * * *** * * ***** ***** *** * * * * *
* *   * * *     *   *   * *     * * * * * * *
* * * * * *********** * * * ***** * * * * * *
*   * * * * *         *   * *     *   * * * *
***** * * * * *** ******* * ***** ******* * *
* *   * * *     *       * * *       *     * *
* * *** * * ********* * * * * ***** * * * ***
* *   * * * *       * * * *   *   * * * *   *
* * *** * *** ***** * * * ***** *** * * *** *
*   *   *   *   * * * * *   *   *   * * * * *
* *** ***** * * * * * * *** *** * *** * * * *
*   *   * * * * *   * *   *     * *   * * * *
* ***** * * *** * ******* * ***** ***** * * *
* *     *   *   *       * * *   *   *   *   *
* * ***** *** ********* * *** * *** * *******
* * *   * *           * * *   *   * *       *
* * *** * * ********* * * * ***** * ***** * *
* *   *   *       *   * * *   *   *     * * *
* *** * *********** *** * *** * ******* * * *
* *   * *         * *       * * *       * * *
* * *** *** ***** * ********* * * ********* *
* * *   *   * *   *   *       * * *   *     *
* * * *** *** * *** * * ******* * * * * * ***
* * *     * *   *   * *   *   *   * *   *   *
*** ******* * ******* *** * * ********* *** *
*   * *           *   * * * *         *   * *
* *** * ********* * * * * *** ******* * *** *
*   * *     *   *   *   *   * *     * * *   *
*** * *** *** * *********** * ***** * *** * *
*   *     *   *     *     * * *     *     * *
* *** ***** ******* * *** * * * *********** *
* *   *   * *       * * * *   *   *         *
* *** * * * * ******* * * ***** * * *********
*   *   * * *         * *     * * *       * *
* * ******* *********** * ***** * ******* * *
* *                     *       *           *
*********************** *********************
