63 45
*********************** *********************
* *         *           *     *   *     *   *
* * ***** * *** * ***** * * * * * *** * * * *
*   * *   *   * * *   * * * *   *     *   * *
* *** * ***** *** * * * *** *************** *
* *   *   * *     * *   *   *         *   * *
* * * *** * ******* ***** *** *** ***** * * *
*   * *   * *     * *     * * * *       * * *
***** * *** * *** * * * *** * * ********* * *
*     * *   *   *   * *   *         *   * * *
* ***** * * *** ***** *** * ***** *** * * * *
*   *   * * *   *     * * * *   * *   * *   *
*** * *** * * ***** *** * *** * * * *** *****
* * *   * * * *   *     *     * * *   *     *
* * *** * * * * * *** ********* * *** ***** *
*   *   * * *   * * * *   *     *   *     * *
* *** *** ******* * * * * * *********** *** *
* *   *         * *   * * * *   *       *   *
* * *** *** ***** ***** * * * * * ******* ***
* *   * *   *   *       *   * *   *     *   *
* *** *** *** * *********** * ***** * * *** *
* *   *   *   *             *     * * * * * *
* * *** *** ********************* *** * * * *
* * *         *         *       *     *   * *
* * ********* ***** ***** ***** *** ******* *
* *       *         *   *     * *   *     * *
* ******* ********* * * ***** * * *** *** * *
*   *   *     *   * * *       *   * * *   * *
*** * ******* * * *** ************* * * *** *
* *   *       * *     *     *   *   * *     *
* *** * ***** * ********* * * * * * * *******
* *   * *     * *       * *   *   * *     * *
* * *** ******* ***** * * ******* ******* * *
*   * *       *       *   *     * *       * *
* *** ******* ************* ***** * ******* *
*           *   *   *       *     *       * *
************* * * * * ***** * *********** * *
*   *   *     *   *   * *   *   *       *   *
* * * * * * *********** * ***** * ***** *****
* *   *   * *     *       *     * *   * *   *
* *** ******* *** ********* ***** * * * * * *
* *   *       *   *       * *   * * *   * * *
* ***** ******* *** ***** * * * * * ******* *
* *     *     *   * *   *   * *   *   *     *
* * ********* *** * * ******* ******* *** * *
* *             *   *       *       *     * *
* ************* ***** ***** * ***** ******* *
*             *     * *   *       *   *     *
* * ********* ***** * * * ********* * * *****
* * *   * *   *   * * * * *   *   * * *   * *
* * * * * * *** * * * * * * * * * *** *** * *
* * * * *       * * * * *   * * *   *   *   *
* * * * *********** *** ***** * *** *** *** *
* *   *           *   * * *   *   *     *   *
* ******* ******* *** * * * ***** ******* ***
*   *   * *         *   * *     * *     *   *
***** * *** ******* ***** ***** * * *** *** *
*     *     *       *         *   * * *     *
* *************** *** ******* ***** * *******
* *             * *   *           *   *     *
* * *********** *** *** ************* *** * *
*             *       *                   * *
*********************** *********************
